11 28
2A00 2A00 2A00 2A00 2A00 2A00 2A00 2A00 2A00 2A00 2A00 2A00 2A00 2A00 2A00 2A00 2A00 2A00 2A00 2A00 2A00 2A00 2A00 2A00 2A00 2A00 2A00 2A00 
2A00 0A00 0A00 0A00 0A00 0A00 0A00 0A00 0A00 0A00 0A00 0A00 0A00 0A00 0A00 0A00 0A00 0A00 0A00 0A00 0D07 0A00 0A00 0A00 0A00 0A00 0A00 2A00 
2A00 0A00 0A00 0A00 0A00 0A00 0A00 0A00 0A00 0A00 0A00 0A00 0A00 0A00 0A00 0A00 0A00 0A00 0A00 0A00 0A00 0A00 0A00 0A00 0A00 0A00 0A00 2A00 
2A00 0A00 0A00 0A00 0I02 0A00 0K01 0A00 0F10 0I03 0A00 0E05 0G05 0A00 0C00 0A00 0A00 0A00 0A00 0A00 0A00 0A00 0A00 0A00 0A00 0A00 0A00 2A00 
2A00 0A00 0A00 0A00 0A00 0A00 0A00 0A00 0A00 0A00 0A00 0A00 0A00 0A00 0A00 0A00 0A00 0A00 0A00 0A00 0A00 0A00 0A00 0A00 0A00 0D02 0A00 2A00 
2A00 0D05 0A00 0A00 0A00 0A00 0A00 0A00 0A00 0A00 0A00 0A00 0A00 0A00 0A00 0A00 0A00 0A00 0A00 0A00 0A00 0A00 0A00 0A00 0A00 0A00 0A00 2A00 
2A00 0A00 0A00 0A00 0A00 0A00 0A00 0A00 0A00 0A00 0A00 0A00 0A00 0A00 0A00 0A00 0A00 0A00 0A00 0A00 0A00 0A00 0A00 0A00 0A00 0A00 0A00 2A00 
2A00 0A00 0A00 0A00 0A00 0A00 0A00 0A00 0A00 0A00 0A00 0A00 0A00 0A00 0A00 0A00 0A00 0A00 0A00 0A00 0A00 0A00 0A00 0A00 0A00 0A00 0A00 2A00 
2A00 0A00 0A00 0A00 0A00 0A00 0A00 0A00 0A00 0B00 0A00 0A00 0A00 0A00 0A00 0A00 0A00 0A00 0A00 0A00 0A00 0A00 0A00 0A00 0A00 0A00 0A00 2A00 
2A00 0A00 0A00 0A00 0A00 0A00 0A00 0A00 0A00 0A00 0A00 0A00 0A00 0A00 0A00 0A00 0A00 0A00 0A00 0A00 0A00 0A00 0A00 0A00 0A00 0A00 0A00 2A00 
2A00 2A00 2A00 2A00 2A00 2A00 2A00 2A00 2A00 2A00 2A00 2A00 2A00 2A00 2A00 2A00 2A00 2A00 2A00 2A00 2A00 2A00 2A00 2A00 2A00 2A00 2A00 2A00 
