11 28
2A00 2A00 2A00 2A00 2A00 2A00 2A00 2A00 2A00 2A00 2A00 2A00 2A00 2A00 2A00 2A00 2A00 2A00 2A00 2A00 2A00 2A00 2A00 2A00 2A00 2A00 2A00 2A00 
2A00 0A00 0A00 0A00 0A00 0A00 0A00 0A00 0A00 0A00 0A00 0A00 0A00 0A00 0A00 0A00 0A00 0A00 0A00 0A00 0D07 0A00 0A00 0A00 0A00 0A00 0A00 2A00 
2A00 0A00 0A00 0A00 0A00 0A00 0A00 0C00 0A00 0A00 0A00 0A00 0A00 0A00 0A00 0A00 0A00 0A00 0A00 0A00 0A00 0A00 0A00 0A00 0A00 0A00 0A00 2A00 
2A00 0A00 0A00 0A00 0A00 0A00 0A00 0A00 0A00 0A00 0A00 0A00 0A00 0A00 0A00 0A00 0A00 0A00 0A00 0A00 0A00 0A00 0A00 0A00 0A00 0A00 0A00 2A00 
2A00 0A00 0A00 0A00 0A00 0A00 0A00 0A00 0A00 0A00 0A00 0A00 0C00 0A00 0A00 0A00 0A00 0A00 0A00 0A00 0A00 0A00 0A00 0A00 0A00 0D02 0A00 2A00 
2A00 0D05 0A00 0A00 0A00 0A00 0A00 0C00 0A00 0A00 0A00 0A00 0A00 0A00 0A00 0A00 0A00 0A00 0A00 0A00 0A00 0A00 0A00 0A00 0A00 0A00 0A00 2A00 
2A00 0A00 0A00 0A00 0A00 0A00 0A00 0A00 0A00 0A00 0A00 0A00 0A00 0A00 0A00 0A00 0A00 0A00 0A00 0A00 0A00 0A00 0A00 0A00 0A00 0A00 0A00 2A00 
2A00 0A00 0A00 0A00 0A00 0A00 0A00 0A00 0A00 0A00 0A00 0A00 0A00 0A00 0A00 0A00 0A00 0A00 0A00 0A00 0A00 0A00 0A00 0A00 0A00 0A00 0A00 2A00 
2A00 0A00 0A00 0A00 0A00 0A00 0A00 0C00 0A00 0A00 0A00 0A00 0A00 0A00 0A00 0A00 0A00 0A00 0A00 0A00 0A00 0A00 0A00 0A00 0A00 0A00 0A00 2A00 
2A00 0A00 0A00 0A00 0A00 0A00 0A00 0A00 0A00 0A00 0A00 0A00 0A00 0A00 0A00 0A00 0A00 0A00 0A00 0A00 0A00 0A00 0A00 0A00 0A00 0A00 0A00 2A00 
2A00 2A00 2A00 2A00 2A00 2A00 2A00 2A00 2A00 2A00 2A00 2A00 2A00 2A00 2A00 2A00 2A00 2A00 2A00 2A00 2A00 2A00 2A00 2A00 2A00 2A00 2A00 2A00 
