15 15
2A00 2A00 2A00 2A00 2A00 2A00 2A00 2A00 2A00 2A00 2A00 2A00 2A00 2A00 2A00
2A00 0A00 0A00 0A00 0A00 0A00 0A00 0A00 0A00 0A00 0A00 0A00 0A00 0A00 2A00
2A00 0A00 0A00 0A00 0A00 0A00 0A00 0A00 0A00 0A00 0A00 0A00 0A00 0A00 2A00
2A00 0A00 0A00 0A00 0A00 0A00 0A00 0A00 0A00 0A00 0A00 0A00 0A00 0A00 2A00
2A00 0A00 0A00 0A00 1A00 1A00 1A00 0A00 0A00 0A00 0A00 0A00 0A00 0A00 2A00
2A00 0A00 0A00 0A00 1A00 1A00 1A00 0A00 0A00 0A00 0A00 0A00 0A00 0A00 2A00
2A00 0A00 0A00 0A00 1A00 1A00 1A00 0A00 0A00 0A00 0A00 0A00 0A00 0A00 2A00
2A00 0A00 0A00 0A00 0D04 1A00 1A00 0A00 0A00 0A00 0A00 0A00 0A00 0A00 2A00
2A00 0A00 0A00 0A00 0A00 0A00 0A00 0A00 0A00 0A00 0A00 0A00 0A00 0A00 2A00
2A00 0A00 0A00 0A00 0A00 0A00 0A00 0A00 0A00 0A00 0A00 0A00 0A00 0A00 2A00
2A00 0A00 0A00 0A00 0A00 0A00 0A00 0A00 0A00 0A00 0A00 0A00 0A00 0A00 2A00
2A00 0A00 0A00 0A00 0A00 0A00 0A00 0A00 0A00 0A00 0A00 0A00 0A00 0A00 2A00
2A00 0A00 0A00 0A00 0A00 0A00 0A00 0A00 0A00 0A00 0A00 0A00 0A00 0A00 2A00
2A00 0A00 0A00 0A00 0A00 0A00 0A00 0A00 0A00 0A00 0A00 0A00 0A00 0A00 2A00
2A00 2A00 2A00 2A00 2A00 2A00 2A00 2A00 2A00 2A00 2A00 2A00 2A00 2A00 2A00 
