30 30
0B00 0B00 0B00 0B00 0B00 0B00 0B00 0B00 0B00 0B00 0B00 0B00 0B00 0B00 0B00 0B00 0B00 0B00 0B00 0B00 0B00 0B00 0B00 0B00 0B00 0B00 0B00 0B00 0B00 0B00
0B00 0A00 0B00 0F01 0F01 0F01 0F01 0F01 0I03 0B00 0F01 0F01 0F01 0F01 0F01 0F01 0F01 0F01 0F01 0F01 0F01 0F01 0F01 0F01 0F01 0F01 0F01 0F01 0F01 0B00
0B00 0F01 0B00 0F01 0F01 0F01 0F01 0F01 0F01 0B00 0F01 0F01 0F01 0F01 0F01 0F01 0F01 0F01 0F01 0F01 0F01 0F01 0F01 0F01 0F01 0F01 0F01 0F01 0F01 0B00
0B00 0F01 0B00 0F01 0B00 0B00 0B00 0B00 0F01 0B00 0F01 0F01 0F01 0F01 0F01 0F01 0F01 0F01 0F01 0F01 0F01 0F01 0F01 0F01 0F01 0F01 0F01 0F01 0F01 0B00
0B00 0F01 0B00 0F01 0B00 0F01 0F01 0B00 0F01 0B00 0F01 0F01 0F01 0F01 0F01 0F01 0F01 0F01 0F01 0F01 0F01 0F01 0F01 0F01 0F01 0F01 0F01 0F01 0F01 0B00
0B00 0F01 0B00 0F01 0B00 0F01 0F01 0B00 0F01 0B00 0F01 0F01 0F01 0F01 0F01 0F01 0F01 0F01 0F01 0F01 0F01 0F01 0F01 0F01 0F01 0F01 0F01 0F01 0F01 0B00
0B00 0F01 0B00 0F01 0B00 0F01 0F01 0B00 0F01 0B00 0F01 0F01 0F01 0F01 0F01 0F01 0F01 0F01 0F01 0F01 0F01 0F01 0F01 0F01 0F01 0F01 0F01 0F01 0F01 0B00
0B00 0F01 0B00 0F01 0B00 0F01 0F01 0B00 0F01 0B00 0B00 0B00 0B00 0B00 0B00 0B00 0B00 0B00 0B00 0B00 0B00 0B00 0B00 0F01 0F01 0F01 0F01 0F01 0F01 0B00
0B00 0F01 0B00 0F01 0B00 0F01 0F01 0B00 0F01 0F01 0F01 0F01 0F01 0F01 0F01 0F01 0F01 0F01 0F01 0F01 0F01 0F01 0B00 0F01 0F01 0F01 0F01 0F01 0F01 0B00
0B00 0F01 0B00 0F01 0B00 0F01 0F01 0B00 0F01 0F01 0F01 0F01 0F01 0F01 0F01 0F01 0F01 0F01 0F01 0F01 0F01 0F01 0B00 0F01 0F01 0F01 0F01 0F01 0F01 0B00
0B00 0F01 0B00 0F01 0B00 0F01 0F01 0B00 0B00 0B00 0B00 0B00 0B00 0F01 0B00 0B00 0B00 0B00 0B00 0B00 0B00 0F01 0B00 0F01 0F01 0F01 0F01 0F01 0F01 0B00
0B00 0F01 0B00 0F01 0B00 0B00 0F01 0F01 0F01 0F01 0F01 0F01 0B00 0F01 0B00 1A00 1A00 1A00 1A00 1A00 1A00 0I03 0A00 0A00 0A00 0A00 0A00 0A00 0A00 0B00
0B00 0F01 0B00 0F01 0F01 0B00 0F01 0F01 0F01 0F01 0F01 0F01 0B00 0F01 0B00 1A00 1A00 1A00 1A00 1A00 1A00 0A00 0A00 0A00 0A00 0A00 0A00 0A00 0A00 0B00
0B00 0F01 0B00 0B00 0F01 0B00 0F01 0F01 0F01 0F01 0F01 0F01 0B00 0F01 0B00 1A00 1A00 1A00 1A00 1A00 1A00 0A00 0A00 0A00 0A00 0A00 0A00 0A00 0A00 0B00
0B00 0F01 0F01 0B00 0F01 0B00 0F01 0F01 0F01 0F01 0F01 0F01 0B00 0F01 0B00 1A00 1A00 1A00 1A00 1A00 1A00 0A00 0A00 0A00 0A00 0A00 0A00 0A00 0A00 0B00
0B00 0B00 0F01 0B00 0F01 0B00 0F01 0F01 0F01 0F01 0F01 0F01 0B00 0F01 0B00 1A00 1A00 1A00 1A00 1A00 1A00 0A00 0A00 0A00 0A00 0A00 0A00 0A00 0A00 0B00
0B00 0B00 0F01 0B00 0F01 0B00 0B00 0F01 0F01 0F01 0F01 0F01 0B00 0F01 0B00 1A00 1A00 1A00 1A00 1A00 1A00 0A00 0A00 0A00 0A00 0A00 0A00 0A00 0A00 0B00
0B00 0F01 0F01 0B00 0F01 0F01 0B00 0F01 0F01 0F01 0F01 0F01 0B00 0F01 0B00 1A00 1A00 1A00 1A00 1A00 1A00 0A00 0A00 0A00 0A00 0A00 0A00 0A00 0A00 0B00
0B00 0F01 0B00 0B00 0F01 0F01 0B00 0F01 0F01 0F01 0F01 0F01 0B00 0F01 0B00 1A00 1A00 1A00 1A00 1A00 1A00 0A00 0A00 0A00 0A00 0A00 0A00 0A00 0A00 0B00
0B00 0F01 0B00 0B00 0B00 0F01 0B00 0F01 0F01 0F01 0F01 0F01 0B00 0F01 0B00 1A00 1A00 1A00 1A00 1A00 1A00 0A00 0A00 0A00 0A00 0A00 0A00 0A00 0A00 0B00
0B00 0F01 0F01 0F01 0B00 0F01 0B00 0F01 0F01 0F01 0F01 0F01 0B00 0F01 0B00 1A00 1A00 1A00 1A00 1A00 1A00 0A00 0A00 0A00 0A00 0F01 0A00 0A00 0A00 0B00
0B00 0B00 0B00 0F01 0B00 0F01 0B00 0F01 0F01 0F01 0F01 0F01 0B00 0F01 0B00 1A00 1A00 1A00 1A00 1A00 1A00 0A00 0A00 0A00 0A00 0A00 0A00 0A00 0A00 0B00
0B00 0F01 0F01 0F01 0B00 0F01 0B00 0F01 0F01 0F01 0F01 0F01 0B00 0A00 0B00 1A00 1A00 1A00 1A00 1A00 1A00 0A00 0A00 0A00 0A00 0A00 0A00 0A00 0A00 0B00
0B00 0F01 0B00 0B00 0B00 0F01 0B00 0B00 0F01 0F01 0F01 0F01 0B00 0B00 0B00 1A00 1A00 1A00 1A00 1A00 1A00 0A00 0A00 0A00 0A00 0A00 0A00 0A00 0A00 0B00
0B00 0F01 0B00 0F01 0F01 0F01 0F01 0B00 0F01 0F01 0F01 0F01 0F01 0F01 0F01 1A00 1A00 1A00 1A00 1A00 1A00 0A00 0A00 0A00 0A00 0A00 0A00 0A00 0A00 0B00
0B00 0F01 0B00 0I03 0B00 0B00 0F01 0B00 0F01 0F01 0F01 0F01 0F01 0F01 0F01 1A00 1A00 1A00 1A00 1A00 1A00 0A00 0A00 0A00 0A00 0A00 0A00 0A00 0A00 0B00
0B00 0F01 0B00 0B00 0B00 0F01 0F01 0B00 0F01 0F01 0F01 0F01 0F01 0F01 0F01 1A00 1A00 1A00 1A00 1A00 1A00 0A00 0A00 0A00 0A00 0A00 0A00 0A00 0A00 0B00
0B00 0F01 0B00 0B00 0F01 0F01 0B00 0B00 0F01 0F01 0F01 0F01 0F01 0F01 0F01 1A00 1A00 1A00 1A00 1A00 1A00 0A00 0A00 0A00 0A00 0A00 0A00 0A00 0A00 0B00
0B00 0F01 0F01 0F01 0F01 0B00 0B00 0F01 0F01 0F01 0F01 0F01 0F01 0F01 0F01 1A00 1A00 1A00 1A00 1A00 1A00 0A00 0A00 0A00 0A00 0A00 0D04 0A00 0A00 0B00
0B00 0B00 0B00 0B00 0B00 0B00 0B00 0B00 0B00 0B00 0B00 0B00 0B00 0B00 0B00 0B00 0B00 0B00 0B00 0B00 0B00 0B00 0B00 0B00 0B00 0B00 0B00 0B00 0B00 0B00