19 20
2A00 2A00 2A00 2A00 2A00 2A00 2A00 2A00 2A00 2A00 2A00 2A00 2A00 2A00 2A00 2A00 2A00 2A00 2A00 2A00
2A00 0A00 0A00 0A00 0A00 0A00 0A00 0A00 0B00 0A00 0A00 0A00 0A00 0A00 0A00 0A00 0A00 0A00 0A00 2A00
2A00 0A00 0A00 0A00 0A00 0B00 0B00 0A00 0B00 0A00 0A00 0A00 0A00 0A00 0A00 0A00 0A00 0A00 0A00 2A00
2A00 0A00 0A00 0A00 0A00 0B00 0B00 0A00 0B00 0A00 0A00 0A00 0A00 0A00 0A00 0A00 0A00 0A00 0A00 2A00
2A00 0A00 0A00 0A00 0A00 0B00 0B00 0A00 0B00 0A00 0A00 0B00 0B00 0A00 0A00 0A00 0A00 0A00 0A00 2A00
2A00 0B00 0B00 0B00 0B00 0B00 0B00 0A00 0B00 0A00 0A00 0F10 0F10 0B00 0B00 0B00 0B00 0B00 0B00 2A00
2A00 0B00 0B00 0B00 0B00 0B00 0A00 0A00 0B00 0A00 0A00 0F10 0F10 0F10 0F10 0F10 0F10 0B00 0B00 2A00
2A00 0A00 0A00 0A00 0A00 0A00 0A00 0A00 0B00 0A00 0A00 0A00 0A00 0A00 0A00 0A00 0A00 0A00 0D06 2A00
2A00 0A00 0A00 0A00 0A00 0A00 0A00 0A00 0B00 0A00 0A00 0F10 0F10 0F10 0F10 0F10 0F10 0B00 0B00 2A00
2A00 0A00 0A00 0A00 0A00 0A00 0A00 0A00 0B00 0A00 0A00 0F10 0F10 0B00 0B00 0B00 0B00 0B00 0B00 2A00
2A00 0A00 0A00 0A00 0A00 0A00 0A00 0A00 0B00 0A00 0A00 0B00 0B00 0A00 0A00 0A00 0A00 0A00 0A00 2A00
2A00 0B00 0B00 0B00 0B00 0B00 0B00 0A00 0B00 0A00 0A00 0A00 0A00 0A00 0A00 0A00 0A00 0A00 0A00 2A00
2A00 0A00 0A00 0A00 0A00 0D08 0B00 0A00 0B00 0A00 0A00 0A00 0A00 0A00 0A00 0A00 0A00 0A00 0A00 2A00
2A00 0A00 0A00 0K15 0A00 0A00 0B00 0A00 0B00 0A00 0A00 0A00 0B00 0A00 0A00 0A00 0A00 0A00 0A00 2A00
2A00 0A00 0K07 0A00 0A00 0A00 0B00 0A00 0B00 0A00 0A00 0B00 0A00 0B00 0A00 0A00 0A00 0A00 0A00 2A00
2A00 0E10 0A00 0A00 0K34 0A00 0B00 0A00 0A00 0A00 0B00 0A00 0A00 0A00 0B00 0A00 0A00 0A00 0A00 2A00
2A00 0E20 0A00 0A00 0A00 0A00 0B00 0A00 0B00 0B00 0A00 0A00 0A00 0A00 0A00 0B00 0A00 0A00 0A00 2A00
2A00 0A00 0A00 0A00 0A00 0A00 0B00 0A00 0B00 0A00 0A00 0A00 0A00 0A00 0A00 0A00 0B00 0A00 0A00 2A00
2A00 0A00 0A00 0A00 0A00 0A00 0A00 0A00 0A00 0A00 0A00 0A00 0K07 0A00 0A00 0A00 0A00 0B00 0A00 2A00
2A00 2A00 2A00 2A00 2A00 2A00 2A00 2A00 2A00 2A00 2A00 2A00 2A00 2A00 2A00 2A00 2A00 2A00 2A00 2A00