15 16
1A00 1A00 1A00 0B00 0B00 0B00 0B00 0B00 0B00 0B00 0B00 0B00 0B00 0B00 0B00 2A00
1A00 1A00 1A00 0A00 0A00 0A00 0B00 0A00 0A00 0A00 0A00 0A00 0A00 0A00 0B00 2A00
1A00 1A00 1A00 0B00 0A00 0B00 0A00 0A00 0A00 0A00 0A00 0A00 0A00 0B00 0B00 2A00
1A00 1A00 1A00 0A00 0A00 0A00 0A00 0A00 0A00 0A00 0A00 0A00 0B00 0B00 0B00 2A00
1A00 1A00 1A00 0K12 0A00 0F10 0C00 0E10 0A00 0A00 0B00 0B00 0B00 0B00 0B00 2A00
1A00 1A00 1A00 0A00 0A00 0A00 0A00 0A00 0A00 0A00 0B00 0B00 0B00 0B00 0B00 2A00
1A00 1A00 1A00 0A00 0A00 0A00 0A00 0A00 0A00 0A00 0A00 0A00 0A00 0A00 0D01 2A00
1A00 1A00 1A00 0G10 0A00 0A00 0A00 0A00 0A00 0A00 0A00 0A00 0A00 0A00 0A00 2A00
1A00 1A00 1A00 0A00 0B00 0A00 0A00 0A00 0A00 0A00 0B00 0B00 0B00 0B00 0B00 2A00
1A00 1A00 1A00 0A00 0A00 0A00 0A00 0A00 0A00 0A00 0B00 0B00 0B00 0B00 0B00 2A00
1A00 1A00 1A00 0B00 0A00 0A00 0A00 0A00 0A00 0A00 0A00 0A00 0B00 0B00 0B00 2A00
1A00 1A00 1A00 0A00 0A00 0K01 0A00 0I02 0A00 0A00 0A00 0A00 0A00 0B00 0B00 2A00
1A00 1A00 1A00 0A00 0A00 0A00 0A00 0A00 0A00 0A00 0A00 0A00 0A00 0B00 0B00 2A00
1A00 1A00 1A00 0A00 0A00 0L01 0A00 0B00 0A00 0A00 0A00 0A00 0A00 0A00 0B00 2A00
1A00 1A00 1A00 0B00 0B00 0B00 0B00 0B00 0B00 0B00 0B00 0B00 0B00 0B00 0B00 2A00
