15 10
2A00 2A00 2A00 2A00 2A00 2A00 2A00 2A00 2A00 2A00 
2A00 0A00 0A00 0A00 0A00 0A00 0A00 0A00 0A00 2A00 
2A00 0A00 0A00 0A00 0A00 0A00 0A00 0A00 0A00 2A00 
2A00 0A00 0A00 0A00 0A00 0A00 0A00 0A00 0A00 2A00 
2A00 0A00 0B00 0K12 0AE0 0F00 0C00 0A00 0A00 2A00 
2A00 0A00 0A00 0A00 0A00 0A00 0A00 0A00 0A00 2A00 
2A00 0A00 0A00 0A00 0A00 0A00 0A00 0A00 0A00 2A00 
2A00 0A00 0A00 0A00 0D01 0A00 0A00 0A00 0A00 2A00 
2A00 0A00 0A00 0A00 0A00 0A00 0A00 0A00 0A00 2A00 
2A00 0A00 0A00 0A00 0A00 0A00 0A00 0A00 0A00 2A00 
2A00 0A00 0A00 0A00 0A00 0A00 0A00 0A00 0A00 2A00 
2A00 0A00 0A00 0A00 0A00 0K01 0A00 0A00 0A00 2A00 
2A00 0A00 0A00 0A00 0A00 0A00 0A00 0A00 0A00 2A00 
2A00 0A00 0A00 0A00 0A00 0L01 0A00 0A00 0A00 2A00 
2A00 2A00 2A00 2A00 2A00 2A00 2A00 2A00 2A00 2A00 
