10 10
0A00 0A00 0A00 0A00 0A00 0A00 0A00 0A00 0A00 0A00 
0A00 0A00 0A00 0A00 0A00 0A00 0A00 0A00 0A00 0A00 
0A00 0A00 0A00 0A00 0D01 0A00 0A00 0A00 0A00 0A00 
0A00 0A00 0A00 0A00 0K01 0A00 0A00 0A00 0A00 0A00 
0A00 0A00 0A00 0A00 0I01 0A00 0A00 0A00 0A00 0A00 
0A00 0A00 0A00 0A00 0E01 0A00 0A00 0A00 0A00 0A00 
0A00 0A00 0A00 0A00 0F01 0A00 0A00 0A00 0A00 0A00 
0A00 0A00 0A00 0A00 0G01 0A00 0A00 0A00 0A00 0A00 
0A00 0A00 0A00 0A00 0A00 0A00 0A00 0A00 0A00 0A00 
0A00 0A00 0A00 0A00 0A00 0A00 0A00 0A00 0A00 0A00 