15 10
2A00 2A00 2A00 2A00 2A00 2A00 2A00 2A00 2A00 2A00 
2A00 0A00 0A00 0A00 0A00 0A00 0A00 0A00 0A00 2A00 
2A00 0A00 0A00 0A00 0A00 0A00 0A00 0A00 0A00 2A00 
2A00 0A00 0A00 0A00 0A00 0A00 0A00 0A00 0A00 2A00 
2A00 0A00 0A00 0A00 0A00 0A00 0A00 0A00 0A00 2A00 
2A00 0A00 0A00 0A00 0A00 0A00 0A00 0A00 0A00 2A00 
2A00 0A00 0A00 0A00 0A00 0A00 0A00 0A00 0A00 2A00 
2A00 0A00 0A00 0A00 0D01 0A00 0A00 0A00 0A00 2A00 
2A00 0A00 0A00 0A00 0A00 0A00 0A00 0A00 0A00 2A00 
2A00 0A00 0A00 0A00 0A00 0A00 0A00 0A00 0A00 2A00 
2A00 0A00 0A00 0A00 0A00 0A00 0A00 0A00 0A00 2A00 
2A00 0A00 0A00 0A00 0A00 0A00 0A00 0A00 0A00 2A00 
2A00 0A00 0A00 0A00 0A00 0A00 0A00 0A00 0A00 2A00 
2A00 0A00 0A00 0A00 0A00 0L01 0A00 0A00 0A00 2A00 
2A00 2A00 2A00 2A00 2A00 2A00 2A00 2A00 2A00 2A00 
