15 10
2A00 2A00 2A00 2A00 2A00 2A00 2A00 2A00 2A00 2A00 
2A00 0A00 0A00 0A00 0A00 0A00 0A00 0A00 0A00 2A00 
2A00 0A00 0A00 0A00 0A00 0A00 0A00 0A00 0A00 2A00 
2A00 0A00 0A00 0A00 0A00 0A00 0A00 0A00 0A00 2A00 
2A00 0A00 0A00 0A00 0A00 0A00 0A00 0A00 0A00 2A00 
2A00 0A00 0A00 0A00 0A00 0A00 0A00 0A00 0A00 2A00 
2A00 0A00 0A00 0A00 0A00 0A00 0A00 0A00 0A00 2A00 
2A00 0A00 0A00 0A00 0D01 0A00 0A00 0A00 0A00 2A00 
2A00 0A00 0A00 0A00 0A00 0A00 0A00 0A00 0A00 2A00 
2A00 0A00 0A00 0A00 0A00 0A00 0A00 0A00 0A00 2A00 
2A00 0A00 0A00 0A00 0A00 0K01 0A00 0A00 0A00 2A00 
2A00 0A00 0A00 0A00 0A00 0A00 0A00 0A00 0A00 2A00 
2A00 0A00 0A00 0A00 0A00 0L10 0A00 0A00 0A00 2A00 
2A00 0A00 0A00 0A00 0A00 0A00 0A00 0A00 0A00 2A00 
2A00 2A00 2A00 2A00 2A00 2A00 2A00 2A00 2A00 2A00 
